Sequence Name	Sequence
NS_CA_fw	GGACTCCAACACCATGTCAAGC
PB2_ca_fw	GAGAATAAAAGAACTGAGAGATCTAATGTCGC
PB1_ca_fw	GGATGTCAATCCGACTCTACTTTTCC
PA_ca_fw	ACTTTGTGCGACAATGCTTCAATCC
NP_ca_fw	CATCGAAGCCATGGCGTCC
NA_ca_fw	GGTAGTCGGAATAATTAGCCTAATATTGCAAATAGG
M_ca_fw	CTAACCGAGGTCGAAACGTACG
HA_ca_fw	CGATTTTGGTTGTATTATTGTACACGTTCGC
mid_PB2_ca_fw	CAGCTATTCTCAGAAAGGCAACCAGG
mid_PB1_ca_fw	GCAGAAATGCTAGCAAGCATTGACC
mid_PA_ca_fw	GCTACAGGACATTGAAAATGAAGAGAAGATCC
HA_mid_fw	GCTGGATCTGGTATTATCATTTCAGATACACC
NA_mid_fw	TGAGCTGTCCTATTGGTGAAGTTCC
NP_mid_fw	GAGAAAGTCGAAACCCAGGAAACG
NS_mid_fw	GGGAGCAATAGTTGGAGAAATTTCACC
M_mid_fw	GCTATTCAACTGGTGCACTTGCC
NS_CA_rv	GCTTGACATGGTGTTGGAGTCC
PB2_ca_rv	GCGACATTAGATCTCTCAGTTCTTTTATTCTC
PB1_ca_rv	GGAAAAGTAGAGTCGGATTGACATCC
PA_ca_rv	GGATTGAAGCATTGTCGCACAAAGT
NP_ca_rv	GGACGCCATGGCTTCGATG
NA_ca_rv	CCTATTTGCAATATTAGGCTAATTATTCCGACTACC
M_ca_rv	CGTACGTTTCGACCTCGGTTAG
HA_ca_rv	GCGAACGTGTACAATAATACAACCAAAATCG
mid_PB2_ca_rv	CCTGGTTGCCTTTCTGAGAATAGCTG
mid_PB1_ca_rv	GGTCAATGCTTGCTAGCATTTCTGC
mid_PA_ca_rv	GGATCTTCTCTTCATTTTCAATGTCCTGTAGC
HA_mid_rv	GGTGTATCTGAAATGATAATACCAGATCCAGC
NA_mid_rv	GGAACTTCACCAATAGGACAGCTCA
NP_mid_rv	CGTTTCCTGGGTTTCGACTTTCTC
NS_mid_rv	GGTGAAATTTCTCCAACTATTGCTCCC
M_mid_rv	GGCAAGTGCACCAGTTGAATAGC